##########
#A   #   #
# ## # # #
# ## # # #
#    #   #
#  ##### #
#  #     #
#  ### ###
#      B #
##########