#####
#A  #
#   #
#  B#
#####
