#####
#...#
#  .#
#  .#
#####
